1111111111111111111111111
1..                     1
1.        XX            1 
1                       1
1
1               11 
1               1@
1
1           X
1
1
1
ED
1
1111111111111111111111111